name,all_snps,apobec_snps,non_apobec_snps,date,decimal_year,precision
JX878407,41,4,37,2006,2006.5,year
JX878412,40,4,36,2006,2006.5,year
JX878417,40,2,38,2006,2006.5,year
JX878423,41,5,36,2007,2007.5,year
JX878424,38,4,34,2007,2007.5,year
JX878425,40,6,34,2007,2007.5,year
JX878429,40,6,34,2007,2007.5,year
AF380138,125,7,118,1996,1996.5,year
JX878408,33,2,31,2007,2007.5,year
JX878409,38,4,34,2006,2006.5,year
JX878410,24,4,20,2006,2006.5,year
JX878411,38,4,34,2006,2006.5,year
JX878418,44,3,41,2006,2006.5,year
JX878419,38,2,36,2007,2007.5,year
JX878420,38,2,36,2007,2007.5,year
JX878426,42,2,40,2007,2007.5,year
KC257460,33,4,29,1985,1985.5,year
KJ642613,27,5,22,1970,1970.5,year
KJ642618,45,4,41,1990,1990.5,year
KJ642619,38,4,34,1988,1988.5,year
KP849469,37,5,32,2008,2008.5,year
MT724770,39,6,33,2014,2014.5,year
MT724772,39,6,33,2014,2014.5,year
JX878413,34,6,28,2006,2006.5,year
JX878414,34,6,28,2006,2006.5,year
JX878415,34,6,28,2006,2006.5,year
JX878416,35,7,28,2006,2006.5,year
JX878421,35,6,29,2007,2007.5,year
JX878422,35,7,28,2007,2007.5,year
JX878427,34,6,28,2007,2007.5,year
JX878428,34,6,28,2007,2007.5,year
KP849471,27,6,21,1985,1985.5,year
DQ011154,35,4,31,2003,2003.5,year
DQ011155,32,3,29,1979,1979.5,year
HM172544,75,7,68,1979,1979.5,year
KJ642617,15,1,14,1971,1971.5,year
KJ642612,37,5,32,1986,1986.5,year
