name,all_snps,apobec_snps,non_apobec_snps,date,decimal_year,precision
DQ011157.1,73,1,72,2003,2003.5,year
MT903346.1,72,1,71,2003,2003.5,year
MT903347.1,73,1,72,2003,2003.5,year
MT903348.1,73,1,72,2003,2003.5,year
KJ642616.1,62,4,58,1968,1968.5,year
KJ642617,7,1,6,1971,1971.5,year
MT724769.1,51,8,43,2012,2012.5,year
AY741551.1,59,9,50,1970,1970.5,year
DQ011156.1,58,4,54,1970,1970.5,year
KJ136820.1,73,5,68,2012,2012.5,year
KP849470.1,70,4,66,1971,1971.5,year
MN346690.1,81,5,76,2017,2017.5,year
MN346691.1,80,5,75,2017,2017.5,year
MN346692.1,81,5,76,2017,2017.5,year
MN346693.1,73,5,68,2017,2017.5,year
MN346694.1,80,5,75,2017,2017.5,year
MN346695.1,80,5,75,2017,2017.5,year
MN346696.1,80,5,75,2017,2017.5,year
MN346697.1,81,5,76,2017,2017.5,year
MN346698.1,80,5,75,2017,2017.5,year
MN346699.1,81,5,76,2017,2017.5,year
MN346700.1,80,5,75,2017,2017.5,year
MN346701.1,79,5,74,2017,2017.5,year
MN346702.1,78,6,72,2018,2018.5,year
MN346703.1,78,6,72,2018,2018.5,year
KJ642614.1,54,5,49,1965,1965.5,year
